{
	"map_info": {
		"name": "Primitives_3",
		"description": "New Primitive Forms - explore advanced procedural shapes and architectural elements",
		"version": "1.0",
		"format": "json",
		"dimensions": {
			"width": 9,
			"depth": 22,
			"max_height": 2
		},
		"metadata": {
			"difficulty": "intermediate",
			"category": "primitives",
			"estimated_time": "5-6 minutes",
			"learning_objectives": ["Advanced primitives", "Procedural generation", "Architectural forms", "Parametric shapes"]
		}
	},
	"layers": {
		"structure": [
			["1", "1", "1", "1", "1", "1", "1", "1", "1"],
			["1", "1", "1", "1", "1", "1", "1", "1", "1"],
			["1", "2", "1", "2", "1", "2", "1", "2", "1"],
			["1", "1", "1", "1", "1", "1", "1", "1", "1"],
			["1", "1", "1", "1", "1", "1", "1", "1", "1"],
			["1", "1", "1", "1", "1", "1", "1", "1", "1"],
			["1", "2", "1", "2", "1", "2", "1", "2", "1"],
			["1", "1", "1", "1", "1", "1", "1", "1", "1"],
			["1", "1", "1", "1", "1", "1", "1", "1", "1"],
			["1", "1", "1", "1", "1", "1", "1", "1", "1"],
			["1", "2", "1", "2", "1", "2", "1", "2", "1"],
			["1", "1", "1", "1", "1", "1", "1", "1", "1"],
			["1", "1", "1", "1", "1", "1", "1", "1", "1"],
			["1", "1", "1", "1", "1", "1", "1", "1", "1"],
			["1", "2", "1", "2", "1", "2", "1", "2", "1"],
			["1", "1", "1", "1", "1", "1", "1", "1", "1"],
			["1", "1", "1", "1", "1", "1", "1", "1", "1"],
			["1", "1", "1", "1", "1", "1", "1", "1", "1"],
			["1", "1", "1", "1", "1", "1", "1", "1", "1"],
			["1", "1", "1", "1", "1", "1", "1", "1", "1"],
			["1", "1", "1", "1", "1", "0", "1", "1", "1"],
			["0", "0", "0", "0", "1", "1", "1", "0", "0"]
		],
		"interactables": [
			[" ", " ", " ", " ", " ", " ", " ", " ", " "],
			[" ", " ", " ", " ", " ", " ", " ", " ", " "],
			[" ", "lshape", " ", "arch", " ", "profile_chair", " ", "portal_frame", " "],
			[" ", " ", " ", " ", " ", " ", " ", " ", " "],
			[" ", " ", " ", " ", " ", " ", " ", " ", " "],
			[" ", " ", " ", " ", " ", " ", " ", " ", " "],
			[" ", "rectcube", " ", "halocube", " ", "unitcube", " ", "star_primitive", " "],
			[" ", " ", " ", " ", " ", " ", " ", " ", " "],
			[" ", " ", " ", " ", "dark_sphere", " ", " ", " ", " "],
			[" ", " ", " ", " ", " ", " ", " ", " ", " "],
			[" ", "rock_primitive", " ", "parametric_surface:0:0:0.2", " ", "mengersponge", " ", "steppedpyramid", " "],
			[" ", " ", " ", " ", " ", " ", " ", " ", " "],
			[" ", " ", " ", " ", " ", " ", " ", " ", " "],
			[" ", " ", " ", " ", " ", " ", " ", " ", " "],
			[" ", "boxbeam", " ", "proceduralrock", " ", "hollowrock", " ", "modernchair", " "],
			[" ", " ", " ", " ", " ", " ", " ", " ", " "],
			[" ", " ", " ", " ", " ", " ", " ", " ", " "],
			[" ", " ", " ", " ", " ", " ", " ", " ", " "],
			[" ", " ", " ", " ", " ", " ", " ", " ", " "],
			[" ", " ", " ", " ", " ", " ", " ", " ", " "],
			[" ", " ", " ", " ", " ", " ", " ", " ", " "],
			[" ", " ", " ", " ", " ", " ", " ", " ", " "]
		],
		"utilities": [
			[" ", " ", " ", " ", " ", " ", " ", " ", " "],
			[" ", " ", " ", " ", " ", " ", " ", " ", " "],
			[" ", " ", " ", " ", " ", " ", " ", " ", " "],
			[" ", " ", " ", " ", " ", " ", " ", " ", " "],
			[" ", " ", " ", " ", " ", " ", " ", " ", " "],
			[" ", " ", " ", " ", " ", " ", " ", " ", " "],
			[" ", " ", " ", " ", " ", " ", " ", " ", " "],
			[" ", " ", " ", " ", " ", " ", " ", " ", " "],
			[" ", " ", " ", " ", " ", " ", " ", " ", " "],
			[" ", " ", " ", " ", " ", " ", " ", " ", " "],
			[" ", " ", " ", " ", " ", " ", " ", " ", " "],
			[" ", " ", " ", " ", " ", " ", " ", " ", " "],
			[" ", " ", " ", " ", " ", " ", " ", " ", " "],
			[" ", " ", " ", " ", " ", " ", " ", " ", " "],
			[" ", " ", " ", " ", " ", " ", " ", " ", " "],
			[" ", " ", " ", " ", " ", " ", " ", " ", " "],
			[" ", " ", " ", " ", " ", " ", " ", " ", " "],
			[" ", " ", " ", " ", " ", " ", " ", " ", " "],
			[" ", " ", " ", " ", " ", " ", " ", " ", " "],
			[" ", " ", " ", " ", " ", " ", " ", " ", " "],
			[" ", " ", " ", " ", " ", "t", " ", " ", " "],
			[" ", " ", " ", " ", " ", " ", " ", " ", " "]
		]
	},
	"utility_definitions": {
		"t": {
			"type": "teleporter",
			"name": "Next",
			"description": "Continue to next step",
			"properties": {
				"action": "next_in_sequence"
			}
		},
		"s": {
			"properties": {
				"height": 5.5
			}
		}
	},

	"lighting": {
		"ambient_color": [0.4, 0.4, 0.5],
		"ambient_energy": 0.6,
		"directional_light": {
			"enabled": true,
			"direction": [-0.4, -0.7, -0.4],
			"color": [1.0, 0.9, 0.8],
			"energy": 1.2
		}
	},
	"settings": {
		"cube_size": 1.0,
		"gutter": 0.0,
		"show_grid": true,
		"enable_physics": true,
		"auto_reveal_on_entry": false,
		"initial_tile_visibility": "hidden_except_corners",
		"background": {
			"type": "sky",
			"color": [0.2, 0.3, 0.7]
		}
	}
}
