{
	"map_info": {
		"name": "Tutorial_Disco",
		"description": "Disco Floor Navigation - large 2D array with interactive pattern tiles",
		"version": "1.0",
		"format": "json",
		"dimensions": {
			"width": 11,
			"depth": 18,
			"max_height": 4
		},
		"metadata": {
			"difficulty": "beginner",
			"category": "tutorial",
			"estimated_time": "4-6 minutes",
			"learning_objectives": ["Large 2D arrays", "Pattern recognition", "Interactive tiles", "Spatial navigation"]
		}
	},
	"layers": {
		"structure": [
			["1", "1", "1", "1", "1", "1", "1", "1", "1", "1", "1"],
			["3", "3", "3", "3", "3", "1", "3", "3", "3", "3", "3"],
			["3", "3", "3", "3", "1", "1", "1", "3", "3", "3", "2"],
			["3", "3", "3", "3", "1", "1", "1", "3", "3", "3", "2"],
			["3", "3", "3", "3", "1", "1", "1", "3", "3", "3", "2"],
			["3", "3", "3", "3", "1", "1", "1", "3", "3", "3", "2"],
			["3", "3", "3", "3", "1", "1", "1", "3", "3", "3", "2"],
			["3", "3", "3", "3", "1", "1", "1", "3", "3", "3", "2"],
			["3", "3", "3", "3", "1", "1", "1", "3", "3", "3", "2"],
			["3", "3", "3", "3", "1", "1", "1", "3", "3", "3", "2"],
			["3", "3", "3", "3", "1", "1", "1", "3", "3", "3", "2"],
			["3", "3", "3", "3", "1", "1", "1", "3", "3", "3", "2"],
			["3", "3", "3", "3", "1", "1", "1", "3", "3", "3", "2"],
			["3", "3", "3", "3", "1", "1", "1", "3", "3", "3", "2"],
			["3", "3", "3", "3", "1", "1", "1", "3", "3", "3", "2"],
			["3", "3", "3", "3", "1", "1", "1", "3", "3", "3", "2"],
			["2", "2", "2", "2", "2", "1", "2", "2", "2", "2", "2"],
		],
		"utilities": [
			[" ", " ", " ", " ", " ", " ", " ", " ", " ", " ", " "],
			[" ", " ", " ", " ", " ", " ", " ", " ", " ", " ", " "],
			[" ", " ", " ", " ", " ", " ", " ", " ", " ", " ", " "],
			[" ", " ", " ", " ", " ", " ", " ", " ", " ", " ", " "],
			[" ", " ", " ", " ", " ", " ", " ", " ", " ", " ", " "],
			[" ", " ", " ", " ", " ", " ", " ", " ", " ", " ", " "],
			[" ", " ", " ", " ", " ", " ", " ", " ", " ", " ", " "],
			[" ", " ", " ", " ", " ", " ", " ", " ", " ", " ", " "],
			[" ", " ", " ", " ", " ", " ", " ", " ", " ", " ", " "],
			[" ", " ", " ", " ", " ", " ", " ", " ", " ", " ", " "],
			[" ", " ", " ", " ", " ", " ", " ", " ", " ", " ", " "],
			[" ", " ", " ", " ", " ", " ", " ", " ", " ", " ", " "],
			[" ", " ", " ", " ", " ", " ", " ", " ", " ", " ", " "],
			[" ", " ", " ", " ", " ", " ", " ", " ", " ", " ", " "],
			[" ", " ", " ", " ", " ", " ", " ", " ", " ", " ", " "],
			[" ", " ", " ", " ", "cube_projectile_spawner", " ", "cube_projectile_spawner", " ", " ", " ", " "],
			[" ", " ", " ", " ", " ", "t", " ", " ", " ", " ", " "],			
						
		],
		"interactables": [
			[" ", " ", " ", " ", " ", " ", " ", " ", " ", " ", " "],
			[" ", " ", " ", " ", " ", " ", " ", " ", " ", " ", " "],
			[" ", " ", " ", " ", " ", " ", " ", " ", " ", " ", " "],
			[" ", " ", " ", " ", " ", " ", " ", " ", " ", " ", " "],
			[" ", " ", " ", " ", " ", " ", " ", " ", " ", " ", " "],
			[" ", " ", " ", " ", " ", " ", " ", " ", " ", " ", " "],
			[" ", " ", " ", " ", " ", " ", " ", " ", " ", " ", " "],
			[" ", " ", " ", " ", " ", " ", " ", " ", " ", " ", " "],
			[" ", " ", " ", " ", " ", " ", " ", " ", " ", " ", " "],
			[" ", " ", " ", " ", " ", " ", " ", " ", " ", " ", " "],
			[" ", " ", " ", " ", " ", " ", " ", " ", " ", " ", " "],
			[" ", " ", " ", " ", " ", " ", " ", " ", " ", " ", " "],
			[" ", " ", " ", " ", " ", " ", " ", " ", " ", " ", " "],

		]
	},
	"utility_definitions": {
		"e": {
			"type": "teleporter",
			"name": "Next Lesson",
			"description": "Continue to the next tutorial",
			"properties": {
				"action": "next_in_sequence"
			}
		},
		"s": {
			"properties": {
				"height": 5.5  
			}
		}
	},
	"lighting": {
		"ambient_color": [0.3, 0.3, 0.4],
		"ambient_energy": 0.6,
		"directional_light": {
			"enabled": true,
			"direction": [-0.3, -0.8, -0.2],
			"color": [0.9, 0.9, 1.0],
			"energy": 0.8
		}
	},
	"settings": {
		"cube_size": 1.0,
		"gutter": 0.0,
		"show_grid": true,
		"enable_physics": true,
		"auto_reveal_on_entry": false,
		"initial_tile_visibility": "hidden_except_start",
		"background": {
			"type": "sky",
			"color": [0.2, 0.2, 0.3]
		}
	}
} 
